############################################################################################
# Grated Community (by Mu, cleaned up by regret-index & modified by rogga for D:2 placement).
#
# A few creatures have built their own little community above ground,
# complete with quaint little homes and a handful of local shops.
#
# Digging or teleportation is NO LONGER required to enter the vault.  A wand of digging
# and scroll of teleportation is no longer available since the grates have an opening now.

: crawl_require('dlua/vault.lua')

{{
function grated_community_house_setup(e)
  e.tags("grated_community_mu_home")
  e.tags("unrand")
  e.tags("allow_dup")
  e.tags("luniq")
  e.kfeat("- = +")
  e.marker("- = lua:restrict_door()")
  single_cloud(e, "#", "flame", false)
    e.ftile("' = floor_vault")
end
}}

default-depth: D:2

NAME:   index_mu_grated_community
TAGS:   no_rotate no_monster_gen no_item_gen no_descent
TAGS:   vaults_hard vaults_orient_s no_wall_fixup
ORIENT: float
DEPTH:  D:2
PLACE:  D:2
WEIGHT: 2000

KMONS:  m = Medusa
MONS:   patrolling goblin, patrolling hobgoblin, patrolling kobold
MONS:   patrolling gnoll / patrolling orc / patrolling adder
MONS:   patrolling adder / patrolling ribbon worm w:2
MONS:   gnoll / orc priest / kobold brigand / sleepcap w:2
KMONS:  8 =  orc priest / kobold brigand w:2
KFEAT:  9 = iron_grate
KFEAT:  0 = granite_statue

SUBST:  z = c

KMONS:  ! = goblin / hobgoblin / kobold / nothing

ITEM:   human skeleton / elf skeleton / kobold skeleton
: kitem("$ = q:" .. crawl.random_range(7, 45) .. " gold")
KFEAT:  g = iron_grate
KFEAT:  f = fountain_sparkling
KFEAT:  A = general shop
KFEAT:  B = scroll shop type:Wondrous suffix:Manuscripts count:10 \
            greed:35 ; scroll of torment | scroll of vulnerability | \
            scroll of noise | scroll of poison | scroll of immolation | \
            scroll of silence
KFEAT:  C = distillery shop type:Miraculous suffix:Elixirs count:10 \
            greed:35 ; potion of mutation | potion of attraction | \
            potion of berserk rage | potion of moonshine | \
            potion of lignification | potion of cancellation
# Moved back into the main vault. Nicolae's Legendary Smithy sells randarts, but
# with a guaranteed downside. It's still possible to find something usable, if
# you don't care about the downside or can make up for it with other things.
KFEAT:  D = armour shop type:Used suffix:Armoury count:5 greed:35 ; \
            robe | leather armour | ring mail | buckler | helmet | \
            pair of gloves | cloak

SHUFFLE:  KLMNOPQR
SUBVAULT: K : grated_community_mu_home_escape
SUBVAULT: L : grated_community_mu_home
SUBVAULT: M : grated_community_mu_home
SUBVAULT: N : grated_community_mu_home
SUBVAULT: O : grated_community_mu_home
SUBVAULT: P : grated_community_mu_home
SUBVAULT: Q : grated_community_mu_home
SUBVAULT: R : grated_community_mu_home
SUBST:    KLMNOPQR = .
KPROP:    ! = no_tele_into
TILE:     c = wall_stone_smooth
TILE:     x = wall_brick_vines
FTILE:    "?tG = floor_grass_dark
COLOUR:   "?t = green
: single_cloud(_G, "#", "flame", false)
FTILE:    .d$ABCDTU123456780H+g = floor_vault
MAP
zzzzzzzzzzzzzzzzzzzzzzzzzzzzzzzzzzzzzzzzzzzzzzzzzzzzz
zxxxxxxxxxxxxxxxxxxxxxxxxxxxxxxxxxxxxcccccccccccccccz
zx"""""""""""""""""""""""""""""""."""cccccccccccccccz
zx""""""""""""""""""""""""""""""...""Gc..........g0cz
zx""KKKKKKK"""LLLLLLL"""MMMMMMM"..."""n..........cccz
zx""KKKKKKK"""LLLLLLL"""MMMMMMM"......+..........g0cz
zx""KKKKKKK"""LLLLLLL"""MMMMMMM"......+.0.......0cccz
zx""KKKKKKK"""LLLLLLL"""MMMMMMM"...""cn..f.....0mg0cz
zx""KKKKKKK"""LLLLLLL"""MMMMMMM"......+.0.......0cccz
zx""KKKKKKK"""LLLLLLL"""MMMMMMM"......+..........g0cz
zx""KKKKKKK"""LLLLLLL"""MMMMMMM"..."""n..........cccz
zx""......K.9.......L.9.......M....""Gcccc+c...c+cccz
zx""."t"t".9T9."t"t".7T9."t"t".....""ccWc..c...c..4cz
zx""......N.9.......O.9.......P....""cc..5.c999c4A.cz
zx""NNNNNNN...OOOOOOO"""PPPPPPP"...""cc....c...c..4$z
zx""NNNNNNN.".OOOOOOO"""PPPPPPP"...""cc#c..c...cccccz
zx""NNNNNNN.t.OOOOOOO"""PPPPPPP"...""ccccc.c...cWcWcz
zx""NNNNNNN.".OOOOOOO"""PPPPPPP"...""cc....c...+.>.cz
zx""NNNNNNN.t.OOOOOOO"""PPPPPPP"...""c$.D7.c...cWcWcz
zx""NNNNNNN.".OOOOOOO"""PPPPPPP"...""ccccccc...cccccz
zx""NNNNNNN...OOOOOOO"""PPPPPPP"...""c$....c999c.d.cz
zx""""""""".9.""""""""""""""""""...""cc.6.6c...nd.dcz
zx"""""""""9T9"""""""""""""""""""."."cc.U6.c...n.d.cz
zx""""""""".9."""""""""""""""""""".".cc....c...n...cz
zx""QQQQQQQQ.RRRRRRRR""xxxxxxxxxxxx."cc6C..c.7.cc+ccz
zx""QQQQQQQ.".RRRRRRR""xccccccccccx".cc....c...c...cz
zx""QQQQQQQ.t.RRRRRRR""xc1......3cx."cc.U..c.9.c5.5cz
zx""QQQQQQQ.".RRRRRRR""xc.c+cc+c.cx".cc....c...+.B.cz
zx""QQQQQQQ.t.RRRRRRR""xc.c1..1c.g.."cc....+...c..5$z
zx""QQQQQQQ.".RRRRRRR""xc.cnccnc..g".cccccccccccccccz
zx""QQQQQQQ...RRRRRRR""xc........gg."cccccccccccccccz
zx"""""""""""""""""""""xc..2..2..cx""""""""""""""""xz
zx"""""""""""""""""""""xc........cx""""""""""""""""xz
zxxxxxxxxxxxxxxxxxxxxxxxc.2....2.cxxxxxxxxxxxxxxxxxxz
zzzzzzzzzzzzzzzzzzzzzzzzz........zzzzzzzzzzzzzzzzzzzz
ENDMAP

#### housing subvaults
# death knight, bound demons, bloody lounge, bricked up window, draugr
NAME:  grated_community_mu_yred_home
TAGS:  patrolling
KMONS: 1 : generate_awake hobgoblin zombie / generate_awake adder zombie
KMONS: 2 : generate_awake orc zombie / generate_awake hound zombie
KMONS: 3 = wight / phantom / shadow imp w:2
KMONS: 4 = wight / phantom
KITEM: 34 = any / nothing
KFEAT: g = iron_grate
KFEAT: _ = altar_yredelemnul / fountain_blood
KPROP: . = bloody / w:4 nothing
KPROP: 1 = no_tele_into
TILE:  c = wall_stone_dark
TILE:  x = wall_brick_darkgray
FTILE: ._+1234?gcx = floor_crypt
: grated_community_house_setup(_G)
MAP
ccccccc
c4c3c4c
cgc+cgc
c.....c
c.1.1.c
c_....c
cccxc+c
      '
ENDMAP

# giant, hides, hearth, deep washroom, closet, lounge feature
NAME:    grated_community_mu_giant_home
TAGS:    no_pool_fixup patrolling
MONS:    gnoll, orc
ITEM:    club / animal skin / nothing
KITEM:   f = hobgoblin skeleton / kobold skeleton / orc skeleton / animal skin
KFEAT:   M = cache_of_meat
KFEAT:   ? = orcish_idol / altar_beogh w:5 / altar_makhleb w:1
SHUFFLE: 1# / 1# / 1# / 1# / 1# / 3!
: single_cloud(_G, "!", "freezing vapour", false)
FTILE:   123456cw#+%M*.8$n~ = floor_pebble_darkgray
TILE:    c = wall_stone_scorched
: grated_community_house_setup(_G)
MAP
ccccccc
cwcc#cc
c-cdMfc
c...1.c
ccc.?.c
cd-...c
cccnc+c
      '
ENDMAP

# spellcaster, living room, workshop, closet
NAME:   grated_community_mu_spellcaster_home
MONS:   orc wizard, orc priest / kobold brigand, gnoll bouda / iguana w:5
MONS:   Sigmund / Terence / Natasha w:4, sleepcap / shadow imp
MONS:   adder w:5
ITEM:   book of minor magic / book of party tricks / nothing
ITEM:   scroll of vulnerability / scroll of immolation / nothing
ITEM:   potion of brilliance / potion of magic / nothing
NSUBST: P = 1:P / *:G
: local q = crawl.random_range(1, 3)
: local s = "any scroll / nothing"
: local p = "any potion / nothing"
: local occupant = crawl.random2(3)
: if occupant == 0 then
KMONS:  P = withered plant
:   kitem("% = $, any wand / w:15 nothing, " .. s)
:   kitem("* = scroll of torment pre_id q:" .. q .. " / nothing, " .. s)
:   kitem("| = potion of magic pre_id q:" .. q .. " / nothing, " .. p)
KFEAT:  C = altar_kikubaaqudgha / altar_sif_muna w:4
SUBST:  & = ddddd., G = GGGGGY
: elseif occupant == 1 then
KMONS:  P = plant
:   kitem("% = $, " .. p .. ", " .. p .. ", " ..p)
:   kitem("% = scroll of vulnerability / nothing, " .. s)
:   kitem("* = potion of magic pre_id q:" .. q .. " / nothing, " .. p)
KFEAT:  C = altar_sif_muna / altar_ashenzari w:5
SUBST:  1 = 2, & = eeeee., G = GTU
: else
KITEM:  % = $, any beam wand / any blast wand, \
            potion of brilliance pre_id / nothing
:   kitem("* = scroll of immolation pre_id / nothing, " .. s)
:   kitem("| = scroll of immolation pre_id q:" .. q .. " / nothing, " .. s)
KFEAT:  C = altar_vehumet / altar_makhleb w:2
KFEAT:  P = cache_of_fruit
SUBST:  1 = 3, & = fffff.
: end
SUBST:  C = C%
FTILE:  .def%*|PCG-+P123456nc = floor_crystal_squares
TILE:   c = dngn_stone_wall_brown
: grated_community_house_setup(_G)
MAP
ccccccc
cCc1.Pc
c.-...c
ccc-c.c
c&..c.c
cP*|c.c
cccnc+c
      '
ENDMAP

# orc, possible family, messy living room w/features, hearth, closet
NAME:   grated_community_mu_orcish_home
MONS:   orc, orc priest, orc wizard
MONS:   gnoll / goblin, hobgoblin / kobold, adder
KITEM:  % = w:12 animal skin / club / hand axe
KITEM:  | = hand axe / leather armour / gold / nothing
KFEAT:  F = cache_of_fruit / cache_of_meat
KFEAT:  ? = altar_beogh / orcish_idol
NSUBST: | = 1:| / *:W, F = 1:F. / *:?, . = 5:% / *:.
SUBST:  2 = 2224, 3 = 3334
FTILE:  .WF?%|#-+cn1234567 = floor_pebble_yellow
TILE:   c = stone_wall_orc
: grated_community_house_setup(_G)
MAP
ccccccc
c|-.1.c
ccc.F2c
c#.3..c
ccc.F.c
c|-...c
cccnc+c
      '
ENDMAP

# troll, cookfire, remains
NAME:   grated_community_mu_troll_home
MONS:   patrolling black bear / patrolling ribbon worm
ITEM:   animal skin
KITEM:  % = any skeleton, any / nothing
NSUBST: . = 2:d / 7:% / *:.
KPROP:  .d% = bloody
FTILE:  ."1+#d%x = floor_dirt
TILE:   x = wall_pebble_darkgray
: grated_community_house_setup(_G)
MAP
xxxxxxx
xx...xx
x.1...x
x..#..x
x.....x
xx"""xx
xxx+xxx
      '
ENDMAP

# taur, entrace w/feature, shooting range, closets
NAME:    grated_community_mu_taur_home
MONS:    patrolling centaur / patrolling kobold brigand, training dummy
ITEM:    any potion / nothing, stone q:1 no_pickup
KMONS:   P = plant
KFEAT:   G = cache_of_fruit w:5
SUBST:   G = GP
NSUBST:  d = 1:dW / *:e
FTILE:   .defWG+-12Pxn = floor_moss
TILE:    c = stone_wall_shoals
: grated_community_house_setup(_G)
MAP
ccccccc
c3fff.c
ccccc-c
cd-.1.c
ccc.G.c
cd-...c
cccnc+c
      '
ENDMAP

NAME:   grated_community_mu_unbuilt_plot
FTILE:  . = floor_pebble_red
COLOUR: . = green
: grated_community_house_setup(_G)
MAP
.......
.......
.......
.......
.......
.......
.......
      '
ENDMAP

NAME:  grated_community_mu_sprite_home
TAGS:  grated_community_mu_home_escape
MONS:  kobold / goblin / hobgoblin, kobold brigand w:4
ITEM:  animal skin / robe / leather armour, any / nothing
KMONS: P = plant
TILE:  x = wall_brick_darkgray
FTILE: .defg1P+- = floor_sandstone
: grated_community_house_setup(_G)
MAP
xxxxxxx
xW-.edx
xxx..xx
x#x..Px
x1....x
xfg...x
xxxnx+x
      '
ENDMAP
